000,011 31000,Intereses,175000,0,175000,75762.89,
000,011 91301,Amortización préstamos largo plazo entidades fin.,906500,10230495,11136995,11136990.04,
000,130 21500,Repar. mant. y cons. Mobiliario,1000,0,1000,1371.21,
000,130 22000,Ordinario no inventariable,10000,0,10000,4111.78,
000,130 22001,"Prensa, revistas, libros y otras publicaciones",1000,0,1000,0,
000,130 22002,Material informático no inventariable,1000,0,1000,0,
000,130 22103,Combustibles y carburantes.,60000,0,60000,38405.23,
000,130 22104,Vestuario,120000,0,120000,4433.16,
000,130 22111,"Suministros de repuestos de maquinaria, utillaje",10000,0,10000,2297.61,
000,130 22204,Teléfonos,10500,0,10500,5596.55,
000,130 22401,Primas de seguros vehiculos mples.,16000,0,16000,13158,
000,132 12000,Sueldos del Grupo A1,11200,0,11200,0,
000,132 12001,Sueldos del Grupo A2,69000,0,69000,70732.92,
000,132 12003,Sueldos del Grupo C1,1275000,0,1275000,1297512.68,
000,132 12004,Sueldos del Grupo C2,8500,0,8500,9937.27,
000,132 12006,Trienios,175000,0,175000,156188.92,
000,132 12100,Complemento de destino,707000,-217398,489602,489601.61,
000,132 12101,Complemento especifico,1370000,-380230,989770,989769.9,
000,132 12102,Complemento de Residencia,190000,-47962,142038,142037.54,
000,132 13000,Retribuciones personal laboral fijo,57000,0,57000,56171.4,
000,132 13100,Retribuciones personal temporal,70000,-48989,21011,21010.12,
000,132 15000,Productividad,30000,0,30000,27775.61,
000,132 15100,Gratificaciones,150000,-35000,115000,113921.8,
000,132 16000,Seguridad Social,1200000,-59827,1140173,1140172.18,
000,132 16200,Formación y Perfeccionamiento del Personal,1000,0,1000,4498.59,
000,132 20200,Arrendamientos de Edificios y Otras Construcciones,23000,0,23000,16370.79,
000,132 20400,Arrendamientos de Material de Transporte,208000,0,208000,126420.58,
000,132 21305,Mantenimiento Cámaras de Seguridad,18000,0,18000,13176.29,
000,132 21400,Repar. conserv. y man. elementos de transporte,30000,0,30000,31998.19,
000,132 22706,Estudios y Trabajos Técnicos,0,54000,54000,56213.56,
000,132 22728,Plan de Seguridad Integral Edificios Municipales,100000,0,100000,0,
000,132 22759,Trabajos de Demolición Edif. Los Cristianos,0,205150,205150,220630.73,
000,132 22760,Realojo derrumbe edf. en Los Cristianos.,0,0,0,15498.63,
000,132 23020,Dietas del personal no directivo,1000,0,1000,656.32,
000,132 23120,Locomoción del personal no directivo,10000,0,10000,11094.67,
000,132 27000,Gastos Imprevistos,0,0,0,0,
000,132 62300,"Maquinaria, Instalaciones y Utillaje",10000,81113,91113,0,
000,132 62400,Material de Transporte,26000,961225,987225,0,
000,132 62500,Mobiliario,10000,0,10000,0,
000,132 62603,Emisoras Policía Local,0,0,0,0,
000,132 62604,Plan de Seguridad Integral Edificios Municipales,70000,-50000,20000,14536.99,
000,133 20000,Arrendamientos de Terrenos y Bienes Naturales,21500,0,21500,0,
000,133 21000,"Reparaciones, man. y conserv. infraestructuras y b",50000,0,50000,4948.06,
000,133 22717,Servicio Grua Municipal,470500,0,470500,470499.48,
000,135 12000,Sueldos del Grupo A1,7406,0,7406,0,
000,135 12100,Complemento de destino,3900,0,3900,0,
000,135 12101,Complemento especifico,6700,0,6700,0,
000,135 12102,Complemento de Residencia,1030,0,1030,0,
000,135 16000,Seguridad Social,6000,0,6000,0,
000,135 26001,Trabajos realizados por Protección Civil,160000,0,160000,82000,
000,135 62400,Material de Transporte,57000,-57000,0,0,
000,136 21303,Mantenimiento de Extintores,18000,0,18000,11747.59,
000,150 10100,Retribuciones báicas,14825,-14825,0,0,
000,150 10101,Otras remuneraciones,34780,-34780,0,0,
000,150 12000,Sueldos del Grupo A1,145000,0,145000,150378.92,
000,150 12001,Sueldos del Grupo A2,56200,0,56200,42782.27,
000,150 12003,Sueldos del Grupo C1,60000,-32964,27036,27035.92,
000,150 12004,Sueldos del Grupo C2,62000,0,62000,85011.8,
000,150 12005,Sueldos del Grupo E,23500,0,23500,29781.63,
000,150 12006,Trienios,64000,0,64000,48217.65,
000,150 12100,Complemento de destino,202000,-63294,138706,138705.62,
000,150 12101,Complemento especifico,440000,-126819,313181,313180.72,
000,150 12102,Complemento de Residencia,47700,0,47700,32072.02,
000,150 13000,Retribuciones personal laboral fijo,365400,-61935,303465,303464.3,
000,150 13100,Retribuciones personal temporal,281000,0,281000,367844.66,
000,150 14301,Retribuciones personal afecto a programas,175300,-86619,88681,88680.9,
000,150 15000,Productividad,5000,0,5000,0,
000,150 15100,Gratificaciones,1000,0,1000,11203.79,
000,150 16000,Seguridad Social,525000,0,525000,505579.63,
000,150 16200,Formación y Perfeccionamiento del Personal,1000,0,1000,772.59,
000,150 20200,Arrendamientos de Edificios y otras construcciones,13500,0,13500,9718.25,
000,150 21400,"Reparación, man. y conserv. elementos de transport",7000,0,7000,9273.22,
000,150 21500,Repar. mant. y cons. Mobiliario,6000,0,6000,1331.64,
000,150 22000,Ordinario no inventariable,6000,0,6000,324.14,
000,150 22001,"Prensa, revistas, libros y otros",1000,0,1000,0,
000,150 22100,Energía eléctrica,250000,0,250000,393719.94,
000,150 22103,Combustibles y carburantes,10000,0,10000,6244.73,
000,150 22111,"Suministro de respuestos de maquinaria, utillaje",0,0,0,2007.48,
000,150 22401,Primas de seguros,7000,0,7000,5955.02,
000,150 22706,Estudios y trabajos técnicos,0,0,0,0,
000,150 23020,Dietas del personal no directivo,1000,0,1000,237,
000,150 23120,Locomoción del personal no directivo,2000,0,2000,711.23,
000,150 60101,Parque Urbano Cho-Parque La Reina ,0,58000,58000,0,
000,150 62300,"Maquinaria, Instalaciones y Utillaje",1000,10000,11000,4558,
000,150 62400,Material de Transporte,0,0,0,0,
000,151 22706,Estudios y trabajos técnicos,400000,-17150,382850,14847.95,
000,151 60000,Adquisición de Terrenos,0,8569848.26,8569848.26,0,
000,151 60104,Gutinado del Solar Municipal C/Duque de la Torre,0,0,0,0,
000,151 60135,Plan de Barrios,0,0,0,0,
000,151 60139,Alumbrado Público en Valle San Lorenzo,0,0,0,0,
000,151 60201,Centro de Transformación Arona Casco,0,673615.09,673615.09,0,
000,151 60806,Parques Infantiles,0,335504.3,335504.3,149932.68,
000,151 60905,Rehabilitación e Ilum. Ext. Sala Multiusos Los Cri,0,1636.14,1636.14,0,
000,151 60911,Centro Civico y Plaza la Camella,0,24128.78,24128.78,0,
000,151 62205,Adecuación N.V. Instalaciones BT Edificios público,0,988000,988000,0,
000,151 62209,Adecuación  Instalaciones CPD Edificios Mples.,0,0,0,0,
000,151 65008,Urbanización en superficie Barranquera Espadal VSL,0,300000,300000,0,
000,1522 21201,Reparación Impermeabilización Cubierta Ed. Admvo.,64200,0,64200,0,
000,1522 60001,Adquisición de Suelo para Construcción V.P.O.,0,210000,210000,0,
000,1522 63213,Adaptación Instalaciones Mpales.Normativa Accesib.,100000,-35000,65000,0,
000,1522 78011,Ayudas Rehabilitacion viviendas 1ª Necesidad,150000,-12050,137950,0,
000,1532 21000,"Reparaciones, man. y conserv. infraestructuras y b",1000,0,1000,0,
000,1532 21005,Plan de Asfaltados 2016,888000,1000000,1888000,525099.89,
000,1532 22713,Servicio de mantenimiento de vías y edificios,2212980,0,2212980,2175319.66,
000,1532 60123,Plan de Accesibilidad,0,10000,10000,0,
000,1532 60901,Mejora de la accesibildad Avda. Chayofita,0,0,0,0,
000,1532 60941,Obras Seguridad Zon Pública CC Apolo Los Cristiano,0,53170.16,53170.16,53170.16,
000,1532 60942,Obras en Crta. Cruz del Guanche-La Sabinita PK 0+0,0,15827,15827,15805.68,
000,1532 60943,Obras Adecuación Conexión Vía Serv. Avda Chayofita,0,0,0,0,
000,1532 60944,"Baranda Protección C/Santa Rita - Abrigaño, Cabo B",0,12900,12900,12013.43,
000,1533 22118,Mobiliario Urbano No Inventariable,15000,0,15000,0,
000,1533 22613,Señalizaciones Municipales,50000,0,50000,13883,
000,1533 22756,Obras de Mejora en Arona Casco,62000,0,62000,0,
000,1533 60901,Pasarela peatonal adaptada en Los Cristianos,18000,0,18000,17976,
000,155 21000,"Reparaciones, mant. y conserv. instraestruc. y B.N",0,0,0,0,
000,155 22613,Señalizaciones Municipales,0,0,0,24062.67,
000,160 22706,Estudios y trabajos técnicos,60000,0,60000,17976,
000,161 22114,Aguas depuradas para riego,200000,0,200000,0,
000,161 22502,Tributos de las Entidades Locales,4300000,0,4300000,4989418.83,
000,161 22711,Servicio Abastecimiento de Agua y Alcantarillado,11600000,1549485,13149485,12537932.39,
000,161 60003,Adquisición de Suelo para Depósitos Municipales,0,120000,120000,0,
000,161 60208,Inversiones Red Saneamiento y Pluviales,0,186663.38,186663.38,32969.28,
000,161 60910,Instalaciones en BT Repetidor La Centinela,0,0,0,0,
000,161 61100,Acondicionamiento Depósitos Municipales de Agua,0,0,0,0,
000,161 76129,Saneamiento y Urbanización en El Fraile III Fase,0,60280.73,60280.73,0,
000,1621 22502,Tributos de las Entidades Locales,0,0,0,186202,
000,1621 22710,Servicio Recogida de Papel Cartón,249000,0,249000,221515.54,
000,1622 22502,Tributos de las Entidades Locales,2300000,0,2300000,2277743.33,
000,1622 22709,Servicio Recogida RSU y Lim. Viaria,12660842,0,12660842,11518236.9,
000,1622 62304,Autocompactadores,0,0,0,0,
000,164 13000,Retribuciones personal laboral fijo,35600,0,35600,37355.34,
000,164 13100,Retribuciones personal temporal,15200,0,15200,13476.27,
000,164 14301,Retribuciones personal afecto a programas,16900,0,16900,17356.4,
000,164 16000,Seguridad Social,20000,0,20000,25366.15,
000,164 21200,Edificios y otras Construcciones,0,0,0,4511.9,
000,164 21306,Mantenimiento Horno Pirolitico Cementerio Mpal.,1300,0,1300,0,
000,164 21500,"Reparación, mant. y conservación mobiliario",0,0,0,6460,
000,164 22104,Vestuario,1000,0,1000,1199.94,
000,164 22110,Productos de limpieza y aseo,1000,0,1000,2130.55,
000,164 22615,Inhumaciones,5000,0,5000,1277.2,
000,164 22706,Estudios y trabajos técnicos,0,0,0,0,
000,164 62214,Ampliación del Cementerio Municipal,55000,120193.93,175193.93,86101.19,
000,164 62302,"Plataformas, Escaleras y Maquinaria",35300,0,35300,35160.71,
000,165 22712,Servicio Mantenimiento Alumbrado Público,1232040,0,1232040,1250512.84,
000,165 42393,Aportación Comité Español Iluminación,601,0,601,440,
000,165 60939,Alumbrado C/ Paralela Avda.Chayofita,80000,0,80000,2675,
000,165 60945,Iluminación Exteriores Pabellón Los Cristianos,0,80000,80000,0,
000,165 62300,"Maquinaria, Instalaciones y Utillaje",5500,0,5500,0,
000,170 12000,Sueldos del Grupo A1,60000,-32224,27776,27775.56,
000,170 12006,Trienios,4000,0,4000,2589.41,
000,170 12100,Complemento de destino,35200,0,35200,11306.55,
000,170 12101,Complemento especifico,72200,-43619,28581,28580.66,
000,170 12102,Complemento de Residencia,8320,0,8320,2777.99,
000,170 13000,Retribuciones personal laboral fijo,73200,0,73200,63928.42,
000,170 13100,Retribuciones personal temporal,33900,0,33900,34602.86,
000,170 14301,Retribuciones personal afecto a programas,19100,0,19100,19798.3,
000,170 15000,Productividad,1000,0,1000,0,
000,170 15100,Gratificaciones,1000,0,1000,0,
000,170 16000,Seguridad Social,80000,0,80000,63606.76,
000,170 16200,Formación y Perfeccionamiento del Personal,1000,0,1000,0,
000,170 21400,Elementos de Transporte,0,0,0,1097.44,
000,170 22000,Ordinario no inventariable,1000,0,1000,730.75,
000,170 22001,"Prensa, revistas, libros y otras publicaciones",1000,0,1000,0,
000,170 22103,Combustibles y carburantes.,3000,0,3000,1831.96,
000,170 22401,Primas de seguros vehículos municipales.,1500,0,1500,1120,
000,170 22602,Publicidad y propaganda,10000,0,10000,627.23,
000,170 22606,"Reuniones, conferencias y cursos.",8000,0,8000,0,
000,170 23020,Dietas del personal no directivo,1000,0,1000,0,
000,170 23120,Locomoción del personal no directivo,2000,0,2000,0,
000,170 48015,Subvención Fundación Neotróopico  Preservación Lag,3000,0,3000,1500,
000,171 20000,Arrendamientos de Terrenos y Bienes Naturales,23000,0,23000,17713.9,
000,171 21000,"Reparaciones, man. y conserv. infraestructuras y b",30000,0,30000,13759.23,
000,171 21006,Colocación Riego Paseo Francisco Andrae,46300,0,46300,0,
000,171 22719,Ajardinamiento Parque de Cho-Parque de la Reina,48000,0,48000,0,
000,171 22741,Servicio Mantenimiento Jardines Municipales,4544248,0,4544248,4536563.28,
000,171 60909,Construcción nueva zona verde Playa de las Vistas,50000,-50000,0,0,
000,171 60946,Parque Infantil Avenida Las Américas,0,407339.39,407339.39,0,
000,171 61904,Remodelación Plaza del Pescador,50000,-50000,0,0,
000,171 61906,Remodelación del Parque Paulino S.R. Las Galletas,0,707703.48,707703.48,0,
000,1721 20900,Cánones,0,0,0,170477.69,
000,1721 21000,"Reparaciones, man. y conserv. infraestructuras y b",0,19000,19000,0,
000,1721 22706,Estudios y trabajos técnicos,0,0,0,5901.05,
000,1721 22730,Mantenimiento Integral del Litoral,0,0,0,327839.03,
000,1721 22736,Servicio de Vigilancia y Socorrismo en Playas,0,0,0,310055.41,
000,1721 62300,"Maquinaria, Instalaciones y Utillaje",0,9799.73,9799.73,9799.73,
000,1721 65913,Aseos y Duchas en Playas,0,0,0,0,
000,1721 65914,Balizamiento Playas,0,0,0,0,
000,1722 20900,Cánones,175000,0,175000,399.19,
000,1722 21000,"Reparaciones, man. y conserv. infraestructuras y b",1000,0,1000,0,
000,1722 21007,Embellecimiento Islas de Contenerización Playas,57600,0,57600,0,
000,1722 21202,Aseos y Duchas Playas Municipales,50000,0,50000,0,
000,1722 21400,"Reparaciones, mante. y conservación elementos de t",2000,0,2000,309.43,
000,1722 21903,Suministro e Instalación Tarimas Playas Mpales.,115000,0,115000,0,
000,1722 22709,Servicio de recogida de basuras y limpieza viaria,25000,0,25000,0,
000,1722 22730,Mantenimiento Integral del Litoral,441510,0,441510,18603.72,
000,1722 22736,Servicio de Vigilancia y Socorrismo en Playas,315335,0,315335,0,
000,1722 22751,Servicio de Baño Adaptado en Arona,0,0,0,6065.11,
000,1723 22706,Estudios y trabajos técnicos,100000,0,100000,0,
000,1723 61905,Plaza de la Trujilla Cabo Blanco,300000,0,300000,0,
000,221 16006,Asistencia Farma-Protésica según Convenio,100000,0,100000,96244.98,
000,221 16008,Asistencia Médico-Farmacéutica,300000,0,300000,205317.47,
000,221 16204,Acción Social,100000,0,100000,106082.43,
000,221 16205,Seguros,90000,0,90000,15120.4,
000,221 16206,Bolsa Convenio Personal Municipal,260000,0,260000,411300.44,
000,231 13000,Retribuciones personal laboral fijo,170000,0,170000,172341.43,
000,231 16000,Seguridad Social,52500,0,52500,57353.35,
000,231 16200,Formación y Perfeccionamiento del Personal,1000,0,1000,25,
000,231 23020,Dietas del personal no directivo,0,0,0,18.7,
000,231 23120,Locomoción del personal no directivo,0,0,0,332.52,
000,231 41003,Al Patronato Municipal de Servicios Sociales,3965507,0,3965507,3965507,
000,231 41004,Plan concertado Prestaciones Básicas S.S. 2016,0,31201.15,31201.15,31201.15,
000,231 41005,Subvención equipos y centros atención a la infanci,0,150477.08,150477.08,150477.08,
000,231 41006,Acciones de Emergencia Social 2016,0,38788.32,38788.32,38788.32,
000,231 41007,Plan Concertado y Prestaciones Básicas S.Sociales,0,87481.95,87481.95,87481.95,
000,231 44221,Subvención a la Empresa Municipal ADESA,1061694,0,1061694,1061694,
000,231 48018,Ayuda Enseres Damnificados Edif. Los Cristianos,0,18000,18000,15000,
000,231 48028,Ayudas al Alquiler Damnificados Ed. Los Cristianos,0,7800,7800,3900,
000,231 48029,Ayudas Parciales Alquiler Damnif. Ed. Los Crist.,0,4800,4800,2400,
000,231 62213,Adecuación N.V. Instalaciones Residencia Mayores C,0,0,0,0,
000,231 62300,"Maquinaria, instalaciones y utillaje",0,6543.22,6543.22,0,
000,231 62400,Material de Transporte,0,0,0,0,
000,231 62500,Mobiliario,0,31374.02,31374.02,0,
000,231 63211,Ampliación Residencia de Mayores Los Cristianos,200000,28000,228000,0,
000,241 13000,Retribuciones personal laboral fijo,74500,0,74500,79945.1,
000,241 13100,Retribuciones personal temporal,120175,0,120175,119148.88,
000,241 14302,Retribuciones convenios AEDL,80000,0,80000,0,
000,241 14303,Retribuciones personal convenios,500000,0,500000,225425,
000,241 14341,Subvención para implementar Plan Especial Empleo S,0,21778.08,21778.08,0,
000,241 14342,Mejora de las Zonas Rurales de Medianias de Arona ,0,34288.87,34288.87,0,
000,241 14343,Programa de Promoción del Empleo Arona 2015,0,201574.96,201574.96,201555.66,
000,241 14344,Dinamizando Arona 2015,0,157460.48,157460.48,156565.55,
000,241 14345,Socorrismo Acuático 2015,0,157460.48,157460.48,158009.18,
000,241 14346,Programa extraordinario bianual 2016-2017,0,340005.84,340005.84,362132.96,
000,241 14347,Mejora Zonas Rurales de Medianias Arona 2016,0,98331.15,98331.15,98331.15,
000,241 14348,Pfae Socorrismo en Espacios Naturales 2016,0,189312.69,189312.69,2306.43,
000,241 14349,Pfae Dinamizando Arona 2016,0,189312.69,189312.69,2895.16,
000,241 16000,Seguridad Social,260000,270095.89,530095.89,308561.27,
000,241 16200,Formación y Perfeccionamiento del Personal,1000,0,1000,0,
000,241 20200,Arrendamientos de Edificios y otras Construcciones,20000,0,20000,12731.38,
000,241 22000,Ordinario no inventariable,1000,0,1000,0,
000,241 22606,"Reuniones, Conferencias y Cursos",80000,0,80000,10619.75,
000,241 22612,Material Convenios Fomento Empleo,30000,40988.52,70988.52,24264.4,
000,241 22706,Estudios y Trabajos Técnicos,88000,0,88000,40939,
000,241 23020,Dietas del personal no directivo,1000,0,1000,74.8,
000,241 23120,Locomoción del personal no directivo,1000,2000,3000,1638.35,
000,241 48014,Convenio Fundación Proyecto D. Bosco,12000,0,12000,0,
000,241 60812,Mobiliario Urbano,0,64205.39,64205.39,0,
000,241 62300,"Maquinaria, Instalaciones y Utillaje",1000,0,1000,0,
000,311 13000,Retribuciones personal laboral fijo,36000,0,36000,37161.61,
000,311 16000,Seguridad Social,12000,0,12000,12410.93,
000,311 16200,Formación y Perfeccionamiento del Personal,600,0,600,0,
000,311 20200,Arrendamientos de Edificios y otras contrucciones,21000,0,21000,15529.8,
000,311 22100,Energía Eléctrica,53000,0,53000,0,
000,311 22115,"Desinfectantes, raticidas",60000,0,60000,45025.6,
000,311 22617,Promoción Sanidad y Consumo,5000,0,5000,4690.56,
000,311 22704,Recogida y acogida de animales.,67000,0,67000,48152.31,
000,311 22722,Recogida Animales Exóticos,3000,0,3000,7220.15,
000,311 22731,Control de Aves.,15000,0,15000,0,
000,312 22100,Energía eléctrica,0,0,0,0,
000,312 22706,Estudios y trabajos técnicos,0,0,0,0,
000,312 62311,Desfibriladores Centros Cívicos Municipales,0,19200,19200,17549.04,
000,320 12001,Sueldos del Grupo A2,3300,0,3300,0,
000,320 12100,Complemento de destino,1850,0,1850,0,
000,320 12101,Complemento especifico,3000,0,3000,0,
000,320 12102,Complemento de Residencia,425,0,425,0,
000,320 13000,Retribuciones personal laboral fijo,206000,-16888,189112,121321.7,
000,320 13100,Retribuciones personal temporal,71200,0,71200,130434.69,
000,320 14301,Retribuciones personal afecto a programas,16700,0,16700,17204.08,
000,320 15000,Productividad,1000,0,1000,0,
000,320 15100,Gratificaciones,1000,0,1000,0,
000,320 16000,Seguridad Social,95000,0,95000,113445.19,
000,320 16200,Formación y Perfeccionamiento del Personal,600,0,600,0,
000,320 22001,"Prensa, revistas, libros y otras publicaciones",1000,0,1000,0,
000,320 22100,Energía eléctrica,100000,0,100000,101457.25,
000,320 22713,Servicio de mantenimiento de vías y edificios,222760,0,222760,205656.23,
000,320 22716,Servicio de Mantenimiento Eléctrico de Edificios,183212,0,183212,183205.92,
000,320 23020,Dietas del personal no directivo,600,0,600,0,
000,320 23120,Locomoción del personal no directivo,600,0,600,164.43,
000,323 21302,Mantenimiento de Ascensores,5000,5000,10000,6107.27,
000,326 22104,Vestuario,0,0,0,1170.45,
000,326 22609,Actividades Culturales y Deportivas,50500,0,50500,35113.1,
000,326 22644,Cursos de Extensión Universitaria,15000,-11000,4000,2232.02,
000,326 22714,Servicios Varios a Colegios,5000,0,5000,0,
000,326 45301,Convenio ULL Máster Innovación Diseño Sect.Turísti,12000,0,12000,0,
000,326 48001,Becas de Transporte,156960,-75360,81600,81599.96,
000,326 48002,Becas Enseñanza Universitaria,253000,0,253000,248600,
000,326 48003,Becas de Enseñanza Especial,55000,-3300,51700,51700,
000,326 48004,Subvenciones APAS,16200,-4500,11700,11700,
000,326 48005,Ayuda Actividades Permanencia (APAS),11550,-8250,3300,3300,
000,3271 13000,Retribuciones básicas,108000,0,108000,73059.01,
000,3271 13100,Personal laboral temporal,82000,0,82000,85170.09,
000,3271 14301,Retribuciones personal afecto a programas,39000,0,39000,39603.69,
000,3271 15100,Gratificaciones,0,0,0,18.19,
000,3271 16000,Seguridad Social,60000,0,60000,83446.25,
000,3271 16200,Formación y perfeccionamiento del personal,600,0,600,513.91,
000,3271 20200,Arrendamientos de edificios y otras construcciones,6000,0,6000,0,
000,3271 22609,Actividades Socioculturales,73500,0,73500,89759.93,
000,3271 22706,Estudios y trabajos técnicos,0,0,0,0,
000,3271 23120,Locomoción del personal no directivo,0,0,0,461.19,
000,3271 62300,"Maquinaria, Instalaciones y Utillaje",5000,11000,16000,14434.8,
000,3272 22302,Servicio de Transporte de Viajeros por Carretera ,41200,0,41200,626.53,
000,330 22100,Energía eléctrica,10000,0,10000,0,
000,330 22204,Teléfonos,5000,0,5000,4697.55,
000,330 22713,Servicio de mantenimiento de vías y edificios,222760,0,222760,204194.43,
000,330 41000,Al Patronato Municipal de Cultura,2550000,0,2550000,2550000,
000,330 41008,Escuelas de Teatro 2015-16,0,0,0,0,
000,3322 12003,Sueldos del Grupo C1,10000,0,10000,13062.71,
000,3322 12006,Trienios,3000,0,3000,2551.86,
000,3322 12100,Complemento de destino,6700,0,6700,5737.08,
000,3322 12101,Complemento específico,10800,0,10800,9999.21,
000,3322 12102,Complemento residencia,1400,0,1400,1401.18,
000,3322 13000,Retribuciones básicas,20000,0,20000,20843.01,
000,3322 13100,Personal Laboral temporal,0,0,0,1755.49,
000,3322 15000,Productividad,1000,0,1000,0,
000,3322 15100,Gratificaciones,1000,0,1000,0,
000,3322 16000,Seguridad Social,15000,0,15000,17164.97,
000,3322 20200,Arrendamientos de Edificios y otras contrucciones,10000,0,10000,7218.91,
000,3322 62510,Estanterías Mecánicas Móviles Archivo,30000,0,30000,0,
000,333 21203,Equipamiento Auditorio Infanta Leonor,0,15000,15000,0,
000,333 62310,Dotacion equipamiento Espacios Culturales de Medi,19000,0,19000,0,
000,3341 62207,Cámaras de Seguridad Edificios,0,0,0,0,
000,336 22609,Actividades Socioculturales,60000,0,60000,14173.94,
000,336 22706,Estudios y trabajos técnicos,127000,0,127000,21560.5,
000,336 48301,Convenio Archivo Diocesano,8000,0,8000,7000,
000,336 48305,Convenio Obispado Restaurac.Retablo Iglesia Arona,0,20000,20000,20000,
000,336 62618,Material Informático Casa de la Bodega,0,8213.3,8213.3,0,
000,336 76200,Acto. Cueva Santo Hermano Pedro,0,62000,62000,0,
000,337 22758,Proyecto de Estudio Uso Escuelitas Los Cristianos,60000,0,60000,0,
000,337 47903,Convenio Uso Instalaciones Casino de Arona,9000,0,9000,4500,
000,337 63212,Proyecto Reforma y Adecuación Cine Arona,60000,0,60000,0,
000,338 22123,Suministro mobiliario actos municipales,50000,0,50000,64996.22,
000,338 22610,Festejos y Actos Populares,175000,0,175000,240701.96,
000,338 22611,Fiestas del Municipio,213000,103298,316298,402222.91,
000,338 22753,Servicios de Sonido e Iluminación para espectaculo,150000,0,150000,0,
000,338 48100,Subvenciones a Comisiones de Fiestas,67400,0,67400,56150,
000,340 22100,Energía eléctrica,231000,0,231000,306910.46,
000,340 41001,Al Patronato Municipal de Deportes,2803400,0,2803400,2803400,
000,341 22706,Estudios y trabajos técnicos,0,0,0,0,
000,341 60921,Mobiliario Urbano Deportivo,50000,0,50000,0,
000,342 22713,Servicio de mantenimiento de vías y edificios,222760,0,222760,204194.43,
000,342 22716,Servicio de Mantenimiento Eléctrico de Edificios,216580,0,216580,193330.18,
000,342 22748,Reacondic. Pavimento Parket Pabellón Las Galletas,0,0,0,0,
000,342 22749,Sustitución Cesped Artificial Anexo Antonio Dguez.,128935,0,128935,120499.83,
000,342 22750,Sustitución Pavimento Pabellón Arona.,54000,0,54000,0,
000,342 22752,Sustitución  césped artificial Pistas de Padel,0,0,0,0,
000,342 22755,Plan Director Actuaciones Complejo Jesús Dguez.,18000,0,18000,0,
000,342 22757,Sustitución Césped Artificial VSL y Villa Isabel,320000,0,320000,278345.89,
000,342 62203,Cubierta Piscina Polivalente de Los Cristianos,0,0,0,0,
000,342 62207,Cámaras de seguridad Edificios Públicos,0,0,0,0,
000,342 62228,Polideportivo Cubierto Valle San Lorenzo,250000,751540.24,1001540.24,0,
000,342 62250,Adecuación Reglamentación B.T. Campo Tiro de Arona,0,2412.74,2412.74,0,
000,342 62312,Cloradores Salinos Piscina Municipal,0,62500,62500,0,
000,342 63208,Adecuación Campo de Tiro de Arona,30000,0,30000,0,
000,414 22121,Suministro Mercadillo Municipal del Agricultor,20000,0,20000,12133.8,
000,414 46600,Aportación Desarrollo Rural Chasna- Isora,3010,0,3010,3000,
000,414 62507,Equipamiento Mercadillo Municipal del Agricultor,80000,0,80000,0,
000,419 62227,Casa del Vino,0,22820.92,22820.92,22820.92,
000,430 41002,Al Patronato Municipal de Turismo,1395645,0,1395645,1395645,
000,430 46902,Convenio Regeneración espacio turístico,93718,0,93718,0,
000,4310 47905,Subvenciones Asoc. Comerciales Fomento y Dinam.,60000,0,60000,0,
000,432 46901,Convenio Promoción Turística SPET,150000,0,150000,0,
000,432 62255,Oficinas de Turismo Plan Q,0,4028.75,4028.75,0,
000,432 75100,Plan de Infraestructurasy Calidad Turística,0,2281944.27,2281944.27,641525.8,
000,432 76124,SPET Plan de Oficinas Turísticas,0,12000,12000,0,
000,433 22614,Plan de Promoción Económica,200000,0,200000,243501.87,
000,433 47906,Subvenciones Fomento Innovación Empresarial,48000,0,48000,266.54,
000,4411 46101,Convenio Transporte Colectivo,138000,0,138000,83862.05,
000,4412 62509,Marquesinas y paneles informativos,60000,0,60000,9967.99,
000,442 22706,Estudios y Trabajos técnicos,50000,0,50000,0,
000,452 60610,Inversiones en la Red de Agua,0,3033253.86,3033253.86,67907.78,
000,453 60137,Conexión Peatonal Guargacho-Las Rosas,0,0,0,0,
000,453 60819,Rehab. pav. de calzada núcleo Valle S.L.,0,0,0,0,
000,453 60918,Rehab. Pav. Calzada Núcleo Valle San Lorenzo.,0,0,0,0,
000,4910 76103,Convenio Ayto-Cabildo Obras Fibra Óptica Mpal.,300000,444043.08,744043.08,0,
000,4911 14301,Retribuciones personal afecto a programas,116000,0,116000,82273.25,
000,4911 16000,Seguridad Social,40000,0,40000,38547.39,
000,4911 16200,Formación y perfeccionamiento del personal,1000,0,1000,0,
000,4911 21004,Acondicionamiento Zonas Verdes en el ámbito URBAN,30500,0,30500,0,
000,4911 21501,Equimpamiento Mobiliario Edificios URBAN,100000,-869,99131,0,
000,4911 21901,Señalética Parque Garañaña URBAN,30000,0,30000,0,
000,4911 22002,"Material Informático no inventariable, Urban 07-15",0,0,0,0,
000,4911 22706,Estudios y Trabajos técnicos,0,175373,175373,121744.6,
000,4911 22732,Servicio Desarrollo Tecnnológico c. Empresarial,0,44849.89,44849.89,2400,
000,4911 22733,Plan formativo empresarial C. empresarial Urban,10000,33600,43600,31140,
000,4911 22740,Estudios y Trabajos. Seguimiento Proyecto URBAN,3500,0,3500,3000,
000,4911 23020,Dietas del personal no directivo,500,0,500,0,
000,4911 23120,Locomoción de Personal,500,0,500,0,
000,4911 62246,Centro Civico Las Galletas,1319852,1687932.5,3007784.5,483094.98,
000,4911 62267,Centro Cívico El Fraile,0,33588.55,33588.55,153811.59,
000,4911 62401,Proyecto Préstamo de Bicicletas y Carril  30,185351,263351,448702,54593.55,
000,4911 62600,Equipos para Procesos de Información,0,39886.39,39886.39,39886.39,
000,4911 62701,Creación Zonas Wi-Fi Zona Urban/Urban Arona 07-15,0,6545.19,6545.19,6545.19,
000,4911 63207,Centro Empresarial Integrado,350418,119258.93,469676.93,416086.94,
000,4911 76103,Convenio Ayto-Cabildo Obras Fibra Óptica Mpal.,0,0,0,0,
000,912 10000,Retribuciones básicas ,720000,0,720000,710513.86,
000,912 11000,Retribuciones básicas,260050,0,260050,141957.3,
000,912 11002,Otras remuneraciones.,3500,0,3500,0,
000,912 16000,Seguridad Social,276351,0,276351,208081.44,
000,912 16200,Formación y Perfeccionamiento del Personal,1000,0,1000,750,
000,912 21400,"Reparación, man. y conserv. elementos de transport",5000,0,5000,3298.25,
000,912 22000,Ordinario no inventariable,1000,0,1000,906.09,
000,912 22001,"Prensa, revistas, libros y otros",1000,0,1000,1086.54,
000,912 22103,Combustibles y carburantes,3000,0,3000,4673.82,
000,912 22105,Productos alimenticios,4000,0,4000,818.85,
000,912 22204,Telefónicas,10000,0,10000,9179.23,
000,912 22401,Primas de seguros,2500,0,2500,2670.01,
000,912 22601,Atenciones protocolarias y representativas,20000,0,20000,32260.56,
000,912 23000,Dietas de Miembros de Órganos de Gobierno,12000,0,12000,4826.56,
000,912 23100,Locomoción de Miembros de Órganos de Gobierno,12000,0,12000,4370.2,
000,912 23300,Asistencia Órganos de Gobierno,60000,0,60000,26605,
000,912 23301,Otras indemnizaciones,50000,0,50000,7119.98,
000,912 48201,Aportaciones a Partidos Políticos,54000,0,54000,49200,
000,920 12000,Sueldos del Grupo A1,156000,0,156000,146708.94,
000,920 12001,Sueldos del Grupo A2,14700,0,14700,18233.74,
000,920 12003,Sueldos del Grupo C1,32500,0,32500,27907.06,
000,920 12004,Sueldos del Grupo C2,75500,0,75500,81630.71,
000,920 12005,Sueldos del Grupo E,27500,0,27500,30950.7,
000,920 12006,Trienios,55000,0,55000,42839.43,
000,920 12100,Complemento de destino,175000,0,175000,130972.48,
000,920 12101,Complemento especifico,385000,-70000,315000,273907.89,
000,920 12102,Complemento de Residencia,41900,0,41900,30936.52,
000,920 13000,Retribuciones personal laboral fijo,311500,0,311500,279005.06,
000,920 13100,Retribuciones personal temporal,359000,0,359000,315663.18,
000,920 14301,Retribuciones personal afecto a programas,150000,0,150000,118931.62,
000,920 15000,Productividad,13120,0,13120,0,
000,920 15100,Gratificaciones,10000,0,10000,16885.35,
000,920 16000,Seguridad Social,520000,0,520000,440795.51,
000,920 16200,Formación y perfeccionamiento del Personal,5000,0,5000,3246.93,
000,920 20200,Arrendamientos de Edificios y otras Construcciones,25000,0,25000,18392.43,
000,920 20400,Arrendamientos de Material de Transporte,205000,-200000,5000,0,
000,920 21000,"Reparaciones, man. y conserv. infraestructuras y b",1000,0,1000,0,
000,920 21200,"Reparaciones, man. y conserv. Edificios y otras co",35000,0,35000,20748.4,
000,920 21300,"Reparaciones, Mante. y conserv. Maquinaria e Inst.",0,0,0,1350.17,
000,920 21304,Mantenimiento Aire Acondicionado,18000,0,18000,17571.72,
000,920 21400,Repar. mant. y conserv. elementos de transporte,7000,0,7000,4043.05,
000,920 21500,Repar. mant. y cons. Mobiliario,2000,0,2000,2922.49,
000,920 21502,Equipamiento Mobiliario Centros Cívicios Medianías,0,0,0,0,
000,920 21600,Repar. mant. y cons. Equipos para procesos informa,30000,0,30000,8103.16,
000,920 22000,Ordinario no inventariable,20000,0,20000,38357.81,
000,920 22001,"Prensa, revistas, libros y otras publicaciones",10000,0,10000,16813.71,
000,920 22002,Material informático no inventariable,250000,60000,310000,391527.2,
000,920 22100,Energía eléctrica,900000,0,900000,938865,
000,920 22103,Combustibles y carburantes,10000,0,10000,4614.46,
000,920 22104,Vestuario,12000,0,12000,14522.67,
000,920 22105,Productos alimenticios,18000,0,18000,25538.19,
000,920 22110,Productos de limpieza y aseo,1000,0,1000,1210.92,
000,920 22112,"Suministros de material electrónico, eléctrico y t",2000,0,2000,3513.13,
000,920 22201,Postales,300000,0,300000,245362.4,
000,920 22203,Informáticas,45000,0,45000,41077.95,
000,920 22204,Telefónicas,52000,0,52000,53954.5,
000,920 22401,Primas de seguros vehículos municipales.,3000,0,3000,2240,
000,920 22602,Publicidad y Propaganda,65000,0,65000,40265.49,
000,920 22603,Publicación en Diarios Oficiales,9000,0,9000,1779.36,
000,920 22604,"Jurídicos, Contenciosos",200000,200000,400000,310822.11,
000,920 22605,Elecciones,0,0,0,8053.15,
000,920 22607,Oposiciones y pruebas selectivas,5000,0,5000,2783.55,
000,920 22616,Plan de Formación Interno Empleados Públicos,10000,0,10000,19591.2,
000,920 22700,Limpieza y Aseo,2270000,0,2270000,1791625.78,
000,920 22701,Seguridad,30000,0,30000,24833.67,
000,920 22706,Estudios y Trabajos Técnicos,220000,0,220000,110022.06,
000,920 22713,Servicio de mantenimiento de vías y edificios,222760,0,222760,204194.43,
000,920 22716,Servicio de Mantenimiento Eléctrico de Edificios,38050,0,38050,61818.92,
000,920 23020,Dietas del personal no directivo,3000,0,3000,265.57,
000,920 23120,Locomoción del personal no directivo,8000,0,8000,1017.65,
000,920 23300,Asistencia Órganos de Gobierno,5000,0,5000,1100,
000,920 62229,Adqusición Locales para servicios municpales,0,800000,800000,0,
000,920 62300,"Maquinaria, Instalaciones y Utillaje",5000,0,5000,9662.53,
000,920 62301,Acondicionamiento Ingeniería CPD Municipales.,15000,0,15000,0,
000,920 62500,Mobiliario,0,0,0,11907.5,
000,920 62600,Equipos para Proceso de Información,400000,0,400000,322045.36,
000,922 12004,Sueldos del Grupo C2,9000,0,9000,11555.73,
000,922 12006,Trienios,2100,0,2100,1936.44,
000,922 12100,Complemento de destino,6000,0,6000,5183.62,
000,922 12101,Complemento específico,7800,0,7800,7763.28,
000,922 12102,Complemento de Residencia,1200,0,1200,1251.09,
000,922 13000,Retribuciones personal laboral fijo,62700,0,62700,67513.15,
000,922 15000,Productividad,1000,0,1000,0,
000,922 15100,Gratificaciones,1000,0,1000,0,
000,922 16000,Seguridad Social,28000,0,28000,28610,
000,922 16200,Formación y Perfeccionamiento del Personal,1000,0,1000,0,
000,922 23020,Dietas del personal no directivo,1000,0,1000,1345.41,
000,922 23120,Locomoción del personal no directivo,600,0,600,935.55,
000,922 42392,Aportación a la FEMP,6000,0,6000,4497.81,
000,924 13100,Retribuciones personal temporal,39000,0,39000,36007.45,
000,924 16000,Seguridad Social,12200,0,12200,20699.64,
000,924 22000,Ordinario no inventariable,1000,0,1000,0,
000,924 22609,Actividades Participación Ciudanana,50000,0,50000,19740.45,
000,924 23020,Dietas del personal no directivo,600,0,600,0,
000,924 23120,Locomoción del personal no directivo,0,0,0,222.6,
000,925 12003,Sueldos del Grupo C1,30000,0,30000,11061.79,
000,925 12004,Sueldos del Grupo C1,60000,0,60000,54265.41,
000,925 12006,Trienios,11000,0,11000,9957.14,
000,925 12100,Complemento de destino,59200,0,59200,29274.58,
000,925 12101,Complemento específico,90000,0,90000,58141.25,
000,925 12102,Complemento de Residencia,12300,0,12300,6710.05,
000,925 13000,Retribuciones básicas,288000,0,288000,287806.07,
000,925 13100,Retribuciones personal temporal,123000,0,123000,178004.04,
000,925 15000,Productividad,33500,0,33500,0,
000,925 15100,Gratificaciones,1000,0,1000,0,
000,925 16000,Seguridad Social,220000,0,220000,230471.31,
000,925 16200,Formación y Perfeccionamiento del Personal,1000,0,1000,0,
000,925 22720,Servicio de Atención Telefónica,620300,0,620300,388753.83,
000,925 23020,Dietas del personal no directivo,1000,0,1000,0,
000,925 23120,Locomoción del personal no directivo,1000,0,1000,100.98,
000,929 12009,Otras Retribuciones básicas.,116500,-92470,24030,0,
000,929 12101,Complemento Especifico.,86800,0,86800,0,
000,929 13002,Otras Remuneraciones,125145,0,125145,0,
000,929 20800,Arrendamientos de Otro Inmovilizado Material,5000,0,5000,1476.6,
000,929 21300,"Reparaciones, Mante. y conserv. Maquinaria e Inst.",10000,0,10000,171.9,
000,929 21400,Repar. mant. y cons. elementos de transporte,1000,0,1000,0,
000,929 21500,Repar. mant. y cons. Mobiliario,2000,0,2000,0,
000,929 22000,Ordinario no inventariable,2000,0,2000,173.9,
000,929 22103,Combustibles y carburantes,1000,0,1000,0,
000,929 22402,Primas de seguros resto,1000,0,1000,0,
000,929 22606,"Reuniones, conferencias y cursos",2000,0,2000,0,
000,929 22619,Sanciones,10000,0,10000,416.47,
000,929 22702,Valoraciones y Peritajes,1000,0,1000,0,
000,929 48102,Premios,3000,0,3000,0,
000,929 50000,Fondo de Contingencia,1000000,0,1000000,0,
000,929 62500,Mobiliario,5000,0,5000,2787.2,
000,931 12000,Sueldos del Grupo A1,97000,0,97000,108855.29,
000,931 12003,Sueldos del Grupo C1,89000,0,89000,52717.88,
000,931 12004,Sueldos del Grupo C2,32000,0,32000,66403.69,
000,931 12006,Trienios,45900,0,45900,39914.97,
000,931 12100,Complemento de destino,155000,0,155000,108083.44,
000,931 12101,Complemento especifico,280000,0,280000,220036.74,
000,931 12102,Complemento de Residencia,30100,0,30100,23262.89,
000,931 13000,Retribuciones básicas.,424000,0,424000,370869.79,
000,931 13100,Retribuciones personal temporal,239000,0,239000,270987.63,
000,931 15000,Productividad,6000,0,6000,5570.64,
000,931 15100,Gratificaciones,1000,0,1000,499.24,
000,931 16000,Seguridad Social,420000,0,420000,385948.27,
000,931 16200,Formación y Perfeccionamiento del Personal,1000,0,1000,896.39,
000,931 20200,Arrendamientos de Edificios y otras Construcciones,10000,0,10000,8038.6,
000,931 21500,Repar. mant. y cons. Mobiliario,1000,0,1000,26.96,
000,931 22000,Ordinario no inventariable,1000,0,1000,930.1,
000,931 22001,"Prensa, revistas, libros y otros",3000,0,3000,1639.39,
000,931 22103,Combustibles y carburantes,0,0,0,325.91,
000,931 22401,Primas de seguros vehículos municipales,0,0,0,333,
000,931 22500,Tributos Estatales,1000,0,1000,3554.42,
000,931 22501,Tributos de las Comunidades Autónomas,1000,0,1000,0,
000,931 22502,Tributos de las Entidades Locales,1000,0,1000,0,
000,931 22618,Intereses y Comisiones,10000,0,10000,39723.84,
000,931 22708,Servicios de Recaudación,1400000,0,1400000,1410891.09,
000,931 23020,Dietas del personal no directivo,1000,0,1000,432.18,
000,931 23120,Locomoción del personal no directivo,6000,0,6000,933.11,
000,931 23300,Otras indemnizaciones,0,0,0,300,
000,931 31100,Gastos de formalización y cancelación,1000,0,1000,0,
000,931 34000,Intereses de depósitos,1000,0,1000,0,
000,931 34100,Intereses de fianzas,1000,0,1000,0,
000,931 35200,Intereses de demora Capítulo 6,100000,0,100000,63659.41,
000,931 35201,Intereses de demora Capítulo 2,100000,0,100000,24403.91,
000,931 35700,Ejecución de Avales,1000,0,1000,0,
000,931 35800,Intereses por operaciones de arrendamiento financi,1000,0,1000,0,
000,931 35900,Otros Gastos Financieros,50000,0,50000,47872.92,
000,931 62207,Cámaras de seguridad Edificios Públicos,0,0,0,0,
000,931 62500,Mobiliario,9000,0,9000,0,
000,931 83001,Anticipos por cuenta terceros,10,27105.36,27115.36,27105.36,
000,931 83101,Anticipo de pagas a personal,10,221400,221410,221400,
000,933 13000,Retribuciones personal laboral fijo,17000,0,17000,20387.92,
000,933 16000,Seguridad Social,5400,0,5400,6952.24,
000,933 16200,Formación y Perfeccionamiento del Personal,600,0,600,0,
000,943 46701,Aportación Consorcio de Incendios,776904,102470,879374,879367.88,
000,,,93873079,37859653.12,131732732.12,96827486.31,
001,330 13000,Retribuciones básicas,142443.76,0,142443.76,317628.57
001,330 13101,Indemnizaciones Personal Laboral Temporal,6,0,6,0
001,330 15100,Gratificaciones,8080,0,8080,3399.48
001,330 16000,Seguridad Social,45582,0,45582,71953.16
001,330 16006,Asistencia farma-protésica según Convenio,13130,0,13130,24424.94
001,330 16008,Asistencia médico farmacéutica,5050,0,5050,1875
001,330 16200,Formación Perfeccionamiento Personal,5669.1,0,5669.1,2391.69
001,330 16204,Acción Social,15500,0,15500,14843.54
001,330 16205,Seguros,6000,0,6000,4546.8
001,330 16206,Bolsa Convenio,23315.85,0,23315.85,18969.34
001,330 20500,Arrendamiento Mobiliario y Enseres,3000,0,3000,0
001,330 21400,"Reparación, Mant. y Conser. Material Transporte",4000,0,4000,2141.79
001,330 21500,Mobiliario y enseres,0,34000,34000,9625.36
001,330 22000,Material de oficina,10000,0,10000,14437.31
001,330 22001,"Prensa, revistas, libros y otras publicaciones",5000,0,5000,3420
001,330 22002,Material informático no inventariable,1000,0,1000,1093.23
001,330 22103,Combustibles y carburantes,6000,0,6000,4447.81
001,330 22124,Mobiliario y Enseres,0,0,0,26857.77
001,330 22199,Otros Suministros,20000,0,20000,4272.19
001,330 22200,Servicio de Telecomunicaciones,6000,0,6000,4396.82
001,330 22300,Transportes,7000,0,7000,6520.38
001,330 22400,Primas de seguro,4000,0,4000,3754.94
001,330 22500,Tributos estatales,3000,0,3000,0
001,330 22501,Tributos CC.AA.,1000,0,1000,0
001,330 22601,Atenciones protocolarias y representativas,1500,0,1500,1968.8
001,330 22604,"Jurídicos, Contenciosos",2000,0,2000,0
001,330 22607,Oposiciones y Pruebas selectivas,2000,0,2000,440.54
001,330 22706,Estudios y Trabajos Técnicos,3500,0,3500,0
001,330 23000,Dietas de los miembros de órganos de gobierno,1000,0,1000,1100
001,330 23020,Dietas personal no directivo,2000,0,2000,1615.6
001,330 23100,Locomoción miembros de órganos de gobierno,1000,0,1000,30.29
001,330 23120,Locomoción personal no directivo,1500,0,1500,1279.23
001,330 23300,Asistencia órganos de gobierno,4000,0,4000,4400
001,330 40002,A Ayuntamiento ,0,369008.36,369008.36,369008.36
001,330 62300,"Maquinaria, instalaciones y utillaje",2000,30852.69,32852.69,23009.36
001,330 62500,Mobiliario,1000,0,1000,0
001,330 62600,Equipos para proceso de Información,6000,21354,27354,32280.63
001,3321 13000,Retribuciones básicas,176743.4,0,176743.4,409072.49
001,3321 13100,Retribuciones Laboral Temporal,44136.51,0,44136.51,339640.32
001,3321 16000,Seguridad Social,71049.45,0,71049.45,70196.99
001,3321 22107,Fonfo Bibliográfico,10000,9000,19000,11680.34
001,3321 62501,Adquisición material biblioteca,1006,0,1006,0
001,3341 11000,Retribuciones básicas,28999.88,0,28999.88,28691.24
001,3341 13000,Retribuciones básicas,177854.95,0,177854.95,316441.73
001,3341 13100,Retribuciones laboral temporal,38962.82,0,38962.82,109825.85
001,3341 16000,Seguridad Social,78661.65,0,78661.65,70541.02
001,3341 21200,Reparación Mant. y Conserv. Edificios y otras cons,15000,32000,47000,44618.51
001,3341 21300,"Reparaciones, Mant. y Conser. Maquinaria Inst Téc ",5000,0,5000,8864.08
001,3341 21302,Mantenimiento de ascensores,23000,0,23000,18234.19
001,3341 22104,Vestuario,10000,0,10000,2973.13
001,3341 22105,Productos alimenticios,1500,0,1500,159.57
001,3341 22108,Limpieza vestuario,1000,0,1000,0
001,3341 22602,Publicidad y propaganda,35000,0,35000,25900.51
001,3341 22609,Actividades Culturales,166980.3,127164.13,294144.43,289646.04
001,3341 22620,Servicio Sonido e Iluminación ,50000,0,50000,7350.68
001,3341 22690,Cursos y Talleres,0,228831.74,228831.74,135925.67
001,3341 22691,Espectáculos de taquilla,0,144144.08,144144.08,85422.32
001,3341 22701,Seguridad,9500,0,9500,8394.77
001,3341 48900,Subvención Asoc. Sociocultural Banda Música Arona,26000,0,26000,26000
001,3342 13000,Retribuciones básicas,446213.75,0,446213.75,36763.02
001,3342 13100,Retribuciones laboral temporal,101386.92,0,101386.92,2159.81
001,3342 16000,Seguridad Social,175905.38,0,175905.38,182662.45
001,3342 22114,Suministro material musical,1000,0,1000,3008.65
001,3342 22709,Servicio reparación de instrumentos,4000,0,4000,3621.39
001,3342 63201,Adquisición Instrumentos Musicales,6500,60000,66500,58708.69
001,337 13000,Retribuciones básicas,434276.38,0,434276.38,0
001,337 13100,Retribuciones laboral temporal,61131.15,0,61131.15,3242.76
001,337 16000,Seguridad Social,159952.75,0,159952.75,76217.74
001,337 62900,Equipamiento,0,91075,91075,39968.04
001,929 13000,Retribuciones Básicas,23900,0,23900,18483.31
001,929 13100,Retribuciones Básicas,7600,0,7600,4561.7
001,931 83101,Anticipos al Personal,0,29300,29300,29300
001,,,2754538.0,1176730,3931268.0,3444409.94
002,340 11000,Retribuciones básicas,28999.88,0,28999.88,26567.27
002,340 13000,Retribuciones básicas,58419.49,0,58419.49,126442.99
002,340 13003,Paga extraordinaria y adicional diciembre 2012,15727.46,0,15727.46,15727.46
002,340 13103,Paga Extraordinaria Diciembre 2012,3850.66,0,3850.66,4645.95
002,340 15100,Gratificaciones,0,0,0,4177.29
002,340 16000,Seguridad Social,33974.2,0,33974.2,96407.95
002,340 16006,Asistencia Farma-Protésica Según Convenio,13000,0,13000,13221.99
002,340 16008,Asistencia médico-farmaceútica,5000,0,5000,2840.71
002,340 16104,Indemnizaciones al personal laboral por jubilación,0,0,0,4500
002,340 16200,Formación y perfeccionamiento del personal,1000,0,1000,1850
002,340 16204,Acción social,18000,0,18000,12762.52
002,340 16205,Seguros,7500,0,7500,5243.08
002,340 16206,Bolsa Convenio,17558.85,0,17558.85,15531.38
002,340 16209,Otros gastos sociales,0,0,0,0
002,340 20500,Arrendamiento de mobiliario y enseres,1000,0,1000,0
002,340 20600,Arrendamiento de Eq. para procesos de información,5,0,5,0
002,340 20800,Arrendamiento de otros inmovilizado material,5,0,5,0
002,340 22002,Material Informático No inventariable,600,0,600,13.8
002,340 22200,Servicios de Telecomunicaciones,10000,0,10000,6329.21
002,340 22601,Atenciones protocolarias y representativas,3000,0,3000,4153.37
002,340 22603,Publicación en Diarios Oficiales,1000,0,1000,0
002,340 22604,"Jurídicos, Contenciosos",1900,0,1900,0
002,340 22606,"Reuniones, Conferencias y Cursos",500,0,500,0
002,340 22607,Oposiciónes y Pruebas Selectivas,5,0,5,0
002,340 22799,Otros trabajos realizados por otras empresas,5,0,5,149.8
002,340 23000,Dietas de los miembros de órganos de gobierno,1800,0,1800,973.52
002,340 23020,Dietas del personal no directivo,900,0,900,643.9
002,340 23100,Locomoción de los órgannos de Gobierno,500,0,500,819.03
002,340 23120,Locomoción del Personal no Directivo,1500,0,1500,976.08
002,340 23300,Otras Indemnizaciones,2000,500,2500,3185.3
002,340 62500,Mobiliario,3000,0,3000,3608.5
002,340 62600,Equipos para Procesos de Información,8000,0,8000,3326.57
002,341 13000,Retribuciones básicas,1005559.92,0,1005559.92,772163.49
002,341 13100,Retribuciones Basicas Personal Temporal,103307.52,0,103307.52,190924.06
002,341 13103,Paga extraordinaria y adicional diciembre 2012,0,0,0,0
002,341 15100,Gratificaciones,10000,0,10000,0
002,341 16000,Seguridad Social,362482.39,0,362482.39,275676.55
002,341 16206,Bolsa Convenio,0,0,0,0
002,341 22001,"Prensa, revistas, libros y otras publicaciones",1000,0,1000,0
002,341 22103,Combustibles y Carburantes,2000,0,2000,8579.55
002,341 22104,Vestuario,6000,0,6000,2937.44
002,341 22300,Transportes,5,0,5,3022.74
002,341 22400,Primas de Seguros,10000,0,10000,8057.19
002,341 22609,Actividades culturales y deportivas,5,0,5,8798.11
002,341 22610,Actos de fomento Deportivo,18000,30000,48000,66906.78
002,341 22612,Gala del Deporte,11000,0,11000,9092.64
002,341 22614,Arona Deporte Natural Verano,10000,0,10000,9323.32
002,341 22615,Medio Maratón de Las Galletas,42000,0,42000,38435.4
002,341 22616,Meeting Internacional Pruebas Combinadas,25000,0,25000,22370.15
002,341 22620,Actividades Deportivas Playa (Deporplaya),4000,0,4000,4000
002,341 22644,Actividades Deportivas Promocionales Golf,10000,0,10000,10000
002,341 22646,Carrera Nocturna Arona K7,5000,0,5000,1385.8
002,341 22653,Acividades Deportivas Promo.Baloncesto,9000,0,9000,9000
002,341 22699,Otros gastos diversos,73.63,0,73.63,2057.04
002,341 22706,Estudios y trabajos técnicos,10000,30000,40000,25934.67
002,341 22709,Servicios Deportivos,150000,0,150000,135592.49
002,341 22710,Servicios Socorristas,40000,0,40000,33034.14
002,341 22799,Otros trabajos realizados por otras empresas y pro,5,0,5,3317.99
002,341 45000,Convenio CCAA Instalaciones IES,13300,0,13300,0
002,341 47900,Subvención Club Hípico del Sur ,4050,0,4050,4050
002,341 48000,Subvenciones,700000,0,700000,689111.36
002,341 48001,Subvención Club Zapatera Export,9720,0,9720,9720
002,341 48002,Subvención Club Teniskuick Los Cristianos,2430,0,2430,0
002,341 48003,Subvención Ledesma Internac de Activid Colombófila,2430,0,2430,2430
002,341 48004,Subvención Sociedad Cazadores Arona Sur,1800,0,1800,1800
002,341 48005,Subv. IES Galletas GFGSAFD,2000,0,2000,2000
002,342 20300,Arrendamiento de maquinaria instalación y utillaje,5,0,5,0
002,342 20500,Arrendamiento de mobiliario y enseres,5,0,5,0
002,342 21200,"Reparac., mantenim. y cons.edif. y otras construc.",20000,60000,80000,71654.01
002,342 21300,"Repar.maquinaria, utillaje, instalaciones tecnicas",6000,0,6000,13562.89
002,342 21301,Mantenimiento Placas Solares,18000,0,18000,0
002,342 21400,"Reparación, mantenimiento  y conserv elem. transp.",3000,0,3000,669.89
002,342 21500,"Reparaciones, mantenim. y conservac. Mobiliario",1466,18000,19466,0
002,342 21901,Mantenimiento Campos Cesped Natural,60000,0,60000,52475.06
002,342 21902,Mantenimiento Césped Artificial,30000,0,30000,29691.52
002,342 22000,Ordinario no inventariable,20000,0,20000,9503.13
002,342 22101,Agua,5,0,5,0
002,342 22103,Combustibles Piscina,120000,0,120000,105590.84
002,342 22106,Productos farmacéuticos y material sanitario,1000,0,1000,0
002,342 22108,Cloros Algicidas y otros,37000,0,37000,6142.31
002,342 22109,Material Deportivo no Inventariable,25000,12000,37000,5517
002,342 22199,Otros Suministros ,500,0,500,17489.51
002,342 22300,Transportes por Carretera,60000,0,60000,37208.85
002,342 22602,Publicidad y propaganda,30000,23500,53500,26094.77
002,342 22700,Limpieza y aseo,5500,0,5500,5073.91
002,342 22701,Seguridad,30000,0,30000,29091.7
002,342 22741,Servicio de Mantenimiento Jardines Municipales,0,35000,35000,17655
002,342 62901,Material Deportivo Inventariable,25000,10000,35000,20447.24
002,342 63200,Edificios y otras construcciones,1000,0,1000,0
002,342 63900,Otras Invers. en Reposición ,1000,0,1000,0
002,931 83101,Anticipos al Personal,0,22600,22600,22600
002,,,3303400,241600,3545000,3174286.21
003,430 11000,Retribuciones Básicas,19999.98,0,19999.98,17743.08
003,430 13000,Retribuciones Básicas,52216.23,0,52216.23,59551.65
003,430 13100,Retribuciones Laboral Temporal,19066.08,0,19066.08,13952.56
003,430 13101,Indeminzación Personal Laboral,6,0,6,0
003,430 15100,Gratificaciones,3000,0,3000,2785.78
003,430 16000,Seguridad Social,32091.09,0,32091.09,29012.8
003,430 16006,Asistencia Farma-Protésica según Convenio,4500,0,4500,2215.5
003,430 16008,Asistencia Médico-Farmaceútica,2500,0,2500,1650
003,430 16200,Formación y Perfeccionamiento del Personal,2000,0,2000,270
003,430 16204,Acción Social,4016,0,4016,1767.86
003,430 16205,Seguros,1500,0,1500,1014.32
003,430 16206,Bolsa Convenio,3742.05,0,3742.05,3454.2
003,430 20200,Arrendamientos de Edificios y otras Construcciones,9500,0,9500,9646.24
003,430 21200,Reparación Mantenimiento Edificios,2000,0,2000,597.91
003,430 21300,Reparación Manten. Consrv.maq. Ins. Utillaje,2000,0,2000,1022.79
003,430 21500,"Reparaciones, matenim. y consrv. Mobiliario",1000,0,1000,1138.48
003,430 21600,Reparaciones mantenim. y conserv. Equipos proc. in,1000,0,1000,0
003,430 22000,Ordinario No Inventariable,6500,0,6500,6232.49
003,430 22001,"Prensa, revistas, libros y publicaciones",2000,0,2000,0
003,430 22002,Material informático no inventariable,1000,0,1000,0
003,430 22105,Productos alimenticios)),0,0,0,1054.12
003,430 22110,Productos de Limpieza y Aseo,1000,0,1000,0
003,430 22199,Otros Suministros,15000,0,15000,4907.05
003,430 22200,Servicios de Telecomunicaciones,5000,0,5000,3115.14
003,430 22400,Primas de Seguros,1000,0,1000,0
003,430 22601,Atenciones Protocolarias y Representativas,5000,0,5000,2840.85
003,430 22700,Limpieza y aseo ,0,0,0,110.4
003,430 23000,Dietas Miembros de los Órganos de Gobierno,1500,0,1500,4124.86
003,430 23020,Dietas personal no directivo,5000,0,5000,8016.25
003,430 23100,Locomoción Organos de Gobierno,6000,0,6000,1535.64
003,430 23120,Locomoción personal no directivo,6000,0,6000,2905.1
003,430 23300,Otras Indemnizaciones,1000,1900,2900,4400
003,430 62300,"Maquinaria, instalación,utillaje",2500,0,2500,0
003,430 62600,Equipos para Proceso de Información,10000,0,10000,5162.25
003,432 13000,Retribuciones Básicas,181475.07,-29000,152475.07,104451.55
003,432 13100,Retribuciones Laboral Temporal,18370.04,0,18370.04,71392.9
003,432 16000,Seguridad Social,65832.34,0,65832.34,49509.45
003,432 20800,Arrendamientos de otro Inmovilizado Material,2000,0,2000,0
003,432 22104,Vestuario,3000,0,3000,939.82
003,432 22105,Productos Alimenticios,1500,0,1500,113.9
003,432 22602,Publicidad y Propaganda,250000,0,250000,129971.15
003,432 22635,Folk Fest Arona,40000,0,40000,36416.22
003,432 22640,Actos de Promoción Turística,359729.12,28400,388129.12,313582.54
003,432 22641,Accesibilidad aplicada al Turismo,80000,0,80000,110726.75
003,432 22642,Nuevas Tecnologías aplicadas al Turismo,50000,0,50000,18190
003,432 22643,Actos de Turismo Deportivo,60500,0,60500,85530.15
003,432 22706,Estudios y trabajos Tecnicos.,40000,-1900,38100,26574.1
003,432 46101,Convenio SATE,7800,-7800,0,0
003,432 62500,Mobiliario,2500,8400,10900,14712.5
003,929 13000,Retribuciones Básicas,3300,0,3300,2458.04
003,929 13100,Retribuciones Laboral Temporal ,1000,0,1000,1841.96
003,931 83002,Anticipos por Cuenta de Terceros,3,3600,3603,3600
003,931 83101,Anticipos al Personal,3,0,3,0
003,,,1395650,3600,1399250,1160238.35
004,230 23300,Asistencia Organos de Gobierno,1400,0,1400,2163.6
004,231 13000,Retribuciones básicas,1074170.23,-18700,1055470.23,851274.17
004,231 13003,Paga extraordinaria y adicional Diciembre 2012,16127.52,0,16127.52,10759.23
004,231 13100,Retribuciones básicas personal laboral temporal,266611.47,215619.55,482231.02,696598.15
004,231 13103,Paga extraordinaria diciembre 2012,14133.42,0,14133.42,17802.77
004,231 14300,Otro personal por tiempo definido,160681.3,0,160681.3,89626.85
004,231 14301,Otro Personal Temporal,18180.08,0,18180.08,0
004,231 15100,Gratificaciones,7000,22900,29900,22948.42
004,231 16000,Seguridad Social,412755.85,0,412755.85,468371.89
004,231 16006,Asistencia Farma-Protésica según Convenio,10000,0,10000,13710.95
004,231 16008,Asistencia médica farmacéutica,3150,0,3150,3544.15
004,231 16104,Indemnizaciónes al personal laboral por jubilación,6,0,6,0
004,231 16200,Formación y perfeccionamiento del personal,3516.1,0,3516.1,1685
004,231 16204,Acción Social ,22000,0,22000,19790.52
004,231 16205,Seguros,4098.38,0,4098.38,3876.94
004,231 16206,Bolsa Convenio,19861.65,0,19861.65,18701.2
004,231 16209,Otros gastos Sociales,0,0,0,0
004,231 20200,Arrendamiento de edificios y otras construcciones,100000,0,100000,87604.76
004,231 20500,Arrendamiento de mobiliario y enseres,6,0,6,0
004,231 21200,Reparación edificios y otras construcciones,6000,4000,10000,4776.79
004,231 21300,"Reparación maquinaria, instalaciones y utillaje",4000,3000,7000,10057.31
004,231 21400,Reparación material de transporte,1000,6000,7000,6506.55
004,231 22000,Ordinario no inventariable,1000,0,1000,21680.53
004,231 22001,"Prensa, revistas, libros y otras publicaciones",1000,0,1000,0
004,231 22002,Material informático no inventarible,600,0,600,2194.36
004,231 22103,Combustibles y carburantes,8000,0,8000,5442.07
004,231 22104,Vestuario,1000,0,1000,1203.3
004,231 22105,Productos alimenticios,2000,0,2000,6322.25
004,231 22106,Productos farmacéuticos y material sanitario,6,0,6,0
004,231 22199,Otros Suministros,500,0,500,2224.16
004,231 22200,Servicios de telecomunicaciones,3000,0,3000,3265.89
004,231 22300,Transportes,90000,-54000,36000,31509.44
004,231 22400,Primas de Seguros,4500,0,4500,8844.18
004,231 22500,Tributos Estatales,0,0,0,0
004,231 22601,Atenciones protocolarias y representativas,2000,0,2000,986.15
004,231 22602,Publicidad y propaganda,3000,0,3000,8623.56
004,231 22603,Publicación en Diarios Oficiales,800,0,800,1845.54
004,231 22604,"Jurídicos, contenciosos",1500,0,1500,856
004,231 22606,"Reuniones, conferencias y cursos",418,0,418,0
004,231 22607,Oposiciónes y pruebas selectivas,200,0,200,0
004,231 22608,Actos de Servicios Sociales,10000,15177.08,25177.08,14130.81
004,231 22610,Actos de Fomento 3ª Edad,70000,17000,87000,90340.46
004,231 22645,Educar Para la Salud,40000,-23050,16950,6869.58
004,231 22646,Servicio de Día El Valito,6000,0,6000,2611.8
004,231 22647,Ludoteca,6000,0,6000,2309.6
004,231 22648,Talleres de Familia,12000,0,12000,160
004,231 22649,Proyectos Educativos,20000,-3000,17000,18260.73
004,231 22650,Ayuda a Domicilio,12300,0,12300,4084.19
004,231 22651,Centro Ocupacional Rosas del Guanche,9000,0,9000,0
004,231 22652,Centro Rehabilitación Psicosocial El Mojón,9000,0,9000,3013.72
004,231 22699,Otros gastos diversos,0,0,0,200.73
004,231 22700,Limpieza y aseo,0,0,0,3723.82
004,231 22706,Estudios y trabajos técnicos,2000,0,2000,195
004,231 22709,Plan Drogodependencia,38000,0,38000,29095.92
004,231 22710,Plan de Igualdad,20000,-4200,15800,17480.98
004,231 22711,Proyecto Campamento de Verano,6000,-3000,3000,0
004,231 22799,Otros trabajos realizados por otras empresas y pro,0,0,0,10284.15
004,231 23000,De los miembros de los órganos de gobierno,3000,0,3000,339
004,231 23020,Del personal no directivo,1500,0,1500,1935.16
004,231 23100,Locomoción de los Organos de Gobierno,6,0,6,65.2
004,231 23120,Locomoción del Personal no Directivo,2000,0,2000,1098.68
004,231 27000,Gastos imprevistos y funciones no clasificadas,1000,0,1000,0
004,231 48000,Subvenciones a Familias e Inst. sin fines de lucro,1000,0,1000,0
004,231 48001,Subvenciones Ayudas de Emergencia Social,1000000,266810.45,1266810.45,1256158.28
004,231 48003,Convenio Cruz Roja Transportes,88000,0,88000,74806.88
004,231 48004,Subvencion Proyecto Cruz Roja Unidad Movil Emerg.S,50000,0,50000,50000
004,231 48005,Subvención Santa Rita,6000,0,6000,6000
004,231 48006,Subvenciones Ayudas Individuales y Tercera Edad,70000,0,70000,0
004,231 48009,Subv. Asociación Española contra el cáncer,3000,0,3000,0
004,231 48010,Subvención Orobal,36000,0,36000,36000
004,231 48011,Subvención Caritas,0,0,0,0
004,231 48012,Subvención Asociación La Bunea Estrella,20000,0,20000,20000
004,231 48013,Subvención Asociación Española Contra el Cancer,12240,0,12240,0
004,231 48014,Subv. Convenio Anillo Insular de Políticas Sociale,15000,0,15000,0
004,231 48016,Convenio Residencia de Mayores de Los Cristianos,0,237146.28,237146.28,237146.28
004,231 48017,Convenio Hogar de Menores,0,260693.2,260693.2,260693.2
004,231 48020,Subvención gestión-funcionamiento Casa Nira,0,398716.64,398716.64,398716.64
004,231 48021,Subvención Convenio U.A.D Comarcal,10000,0,10000,0
004,231 48022,Subvención Directa Punta de Encuentro,30000,-30000,0,0
004,231 48023,Subvención Convenio Cruz Roja Teleasistencia,13000,0,13000,13644.56
004,231 48024,Subvención Agora,4500,0,4500,4500
004,231 48025,Subvención Consignas y Lavandería ,30000,-20000,10000,0
004,231 48026,Subvención Hogar Albergue de Media Exigencia,5000,0,5000,0
004,231 48027,Subvención Housing First,5000,0,5000,0
004,231 62300,"Maquinaria, instalaciones y utillaje",8000,0,8000,14836.88
004,231 62500,Mobiliario,6000,0,6000,0
004,231 62600,Eq. para proceso de información,6000,0,6000,12859.26
004,231 62601,Otros Suministros,5000,0,5000,0
004,231 62602,Otros suministros informáticos,9739,0,9739,1391
004,931 83101,Anticipos Pagas al Personal,0,16900,16900,16900
004,,,3965507,1308013.2,5273520.2,5034649.19
